############
#..........#
#..B.......#
#........R.#
#.....B....#
#..........#
#.R........#
#.....R....#
#..........#
#..........#
#.....P....#
############
