############
#..........#
#..........#
#........B.#
#..........#
#..........#
#.R........#
#..........#
#..........#
#..P.......#
#..........#
############
